####################
#..................#
#.####.....####...#
#.#..#.....#..#...#
#.#..#.....#..#...#
#.####..N..####...#
#.................#
#......P..........#
#.................#
#..###.....###....#
#..#.#.....#.#....#
#..###..D..###....#
#........D........#
#.####.....####...#
#.#..#.....#..#...#
#.#..#.....#..#...#
#.####.....####...#
#.................#
#..................#
####################
